R     1200 900
NO    ./textures/redbrick.xpm
SO    ./textures/greystone.xpm
EA    ./textures/wood.xpm
WE    ./textures/colorstone.xpm
S     ./textures/barrel.xpm


F     077,028,027
C     128,176,255


 111    1111111111111111111111111
 101    1000000000110000002000001
 111    1011000001110000200000201
        1001020000000000002002001
111111111011000001110000000000001
100000000011000011110111110111111
11110111111111011  1000012001
11110111111111011111010010021
11000000110101011100000002001
10202020200000000000000000001
100000000020000011010100100011
11000001110101011111011100N0011
11110111 1110101 1011110100011
11111111 1111111 111111111111
      
111111
100001
111111
